0200 0200 0200 0200 0100 0100 0100 0100 0100 0200
0200 0200 0200 0100 0000 0000 0000 0000 0402 0100
0200 0200 0200 0100 0000 0100 0100 0100 0000 0100
0200 0200 0200 0100 0000 0100 0200 0100 0000 0100
0200 0200 0200 0100 0000 0100 0200 0100 0000 0100
0200 0200 0100 0100 0000 0100 0200 0100 0000 0100
0200 0100 0000 0000 0000 0100 0200 0100 0000 0100
0200 0100 0000 0107 0100 0100 0100 0100 0000 0100
0200 0100 0000 0000 0301 0000 0000 0000 0000 0100
0200 0100 0100 0100 0100 0100 0100 0100 0100 0200